{
  "rows_extracted": 30681,
  "unique_rows": 30681,
  "duplicate_dates": {},
  "coverage_from": "1936-01-01",
  "coverage_to": "2019-12-31",
  "minimum_value": -42,
  "maximum_value": 948,
  "negative_value_count": 52,
  "missing_date_count": 0,
  "missing_dates_sample": [],
  "annual_counts": {
    "1936": 366,
    "1937": 365,
    "1938": 365,
    "1939": 365,
    "1940": 366,
    "1941": 365,
    "1942": 365,
    "1943": 365,
    "1944": 366,
    "1945": 365,
    "1946": 365,
    "1947": 365,
    "1948": 366,
    "1949": 365,
    "1950": 365,
    "1951": 365,
    "1952": 366,
    "1953": 365,
    "1954": 365,
    "1955": 365,
    "1956": 366,
    "1957": 365,
    "1958": 365,
    "1959": 365,
    "1960": 366,
    "1961": 365,
    "1962": 365,
    "1963": 365,
    "1964": 366,
    "1965": 365,
    "1966": 365,
    "1967": 365,
    "1968": 366,
    "1969": 365,
    "1970": 365,
    "1971": 365,
    "1972": 366,
    "1973": 365,
    "1974": 365,
    "1975": 365,
    "1976": 366,
    "1977": 365,
    "1978": 365,
    "1979": 365,
    "1980": 366,
    "1981": 365,
    "1982": 365,
    "1983": 365,
    "1984": 366,
    "1985": 365,
    "1986": 365,
    "1987": 365,
    "1988": 366,
    "1989": 365,
    "1990": 365,
    "1991": 365,
    "1992": 366,
    "1993": 365,
    "1994": 365,
    "1995": 365,
    "1996": 366,
    "1997": 365,
    "1998": 365,
    "1999": 365,
    "2000": 366,
    "2001": 365,
    "2002": 365,
    "2003": 365,
    "2004": 366,
    "2005": 365,
    "2006": 365,
    "2007": 365,
    "2008": 366,
    "2009": 365,
    "2010": 365,
    "2011": 365,
    "2012": 366,
    "2013": 365,
    "2014": 365,
    "2015": 365,
    "2016": 366,
    "2017": 365,
    "2018": 365,
    "2019": 365
  },
  "rejected_rows": []
}